NO ./path_to_the_north_texture







                           SO                  ./path_to_the_south_texture








            WE             ./path_to_the_west_texture


EA ./path_to_the_east_texture

F 220,100,0

C 225,30,0


1111111111111111111111111
1000000000110000000000001
11111111111111111111111111111

111111111111111111111111111111
11000000111111011100000010001
100000001   100001100000010001
100000001   10001101010010001
11000001111111011111011110N0111
11110111 1110101 101111010001
11111111 1111111 111111111111