NO ../img/Tileable1f.xpm
SO ../img/Tileable3e.xpm
WE ../img/Tileable4b.xpm
EA ../img/Tileable6a.xpm
F 110,15,30
C 30,30,30

 111111111111111 1 111111
100000000110000010100001
 111111111111000000000001
           1111111111100111111111111
11111111111110011111111011111
 11000000111111011100000010001
1000000011111000011100000000001
 10000000000000000000000010001
110000011111110111000000000111
11110111 1110101 10101S1000001
11111111 1111111 1111 1 11111