NO         ./img/Tileable1f.xpm





                           SO                  ./img/Tileable3e.xpm








            WE              ./img/Tileable4b.xpm


EA ./img/Tileable6a.xpm

F 30,30,30

C 180,180,180


1111111111111111111111111
100000000110000000000001
11111111111110111111111111111
11111111111110011111111111111
11000000111111011100000010001
100000001   1000011100W0001001
100000001   10001101010010001
110000011111110111110111100111
11110111 1110101 101111010001
11111111 1111111 111111111111