NO         ./path_to_the_north_texture





                           SO                  ./path_to_the_south_texture








            WE              ./path_to_the_west_texture


EA ./path_to_the_east_texture

F 0,0,255

C 0,255,0


1111111111111111111111111
1000000000110000000000001
11111111111110111111111111111
11111111111110011111111111111
11000000111111011100000010001
100000001   1000011100W0010001
100000001   10001101010010001
110000011111110111110111100111
11110111 1110101 101111010001
11111111 1111111 111111111111