NO ./img/Tileable1f.xpm
EA ./img/Tileable6a.xpm
SO ./img/Tileable3e.xpm
WE ./img/Tileable4b.xpm

C 15,255,15
F 60,60,60

1111111111111111111111111
100000000000000000000001
1111111111111000000000001
      11111111111111110011111
11111110000000011111110111111
11000000111111010000000010001
100000001   100000000000001001
100000001   10000001010010001
11000001111111000000W000000111
100000000000000000000000111
1111111111111000000000001
1111111111111111111111111111