NO ./img/Tileable1f.xpm
SO ./img/Tileable3e.xpm
WE ./img/Tileable4b.xpm

EA ./img/Tileable6a.xpm
F 110,15,110
C 30,30,30

1111111111111111111111111
1000000000000000000000001
1111111111111000000000001
      11111111111111110011111
11111110000000011111110111111
11000000111111010000000010001
100000001   100001010000001001
100000001   10001101010010001
110000011111110111110111100111
100000000000000000000000111
1111111111111000000000001
      11111111111111110011111
11111110000000011111110111111
11000000111111010000000010001
100000001   100001010000001001
100000001   10001101010010001
110000011111110111110111100111
100000000000000000000000111
1111111111111000000000001
      11111111111111110011111
11111110000000011111110111111
11000000111111010000000010001
100000001   100001010000001001
100000001   10001101010010001
110000011111110111110111100111
100000000000000000000000111
1111111111111000000000001
      11111111111111110011111
11111110000000011111110111111
11000000111111010000000010001
100000001   100001010000001001
100000001   10001101010010001
110000011111110111110111100111
100000000000000000000000111
1111111111111000000000001
      11111111111111110011111
11111110000000011111110111111
11000000111111010000000010001
100000001   100001010000001001
100000001   10001101010010001
110000011111110111110111100111
100000000000000000000000111
1111111111111000000000001
      11111111111111110011111
11111110000000011111110111111
11000000111111010000000010001
100000001   100001010000001001
100000001   10001101010010001
110000011111110111110111100111
100000000000000000000000111
1111111111111000000000001
      11111111111111110011111
11111110000000011111110111111
11000000111111010000000010001
100000001   100001010000001001
100000001   10001101010010001
110000011111110111110111100111
11110111 1110001 100011000001
11111111 1111111 111111111111