NO         ./path_to_the_north_texture





                           SO                  ./path_to_the_south_texture








            WE              ./path_to_the_west_texture


EA ./path_to_the_east_texture

F 0,0,255

C 0,255,0

11111111111111111111
10001000000000000001
10W01000000000000001
10001000000000000001
10001000000000000001
10001000000000000001
10001000000000000001
10001000000000000001
10001000001111111001
10001000001000001001
10001000001001101001
10001000001000001001
10001000001111001001
10001000000001001001
10001000000001001001
10000000000001000001
10000000000001000001
11111111111111111111